111111111111111
100000000000001
100001000000001
100010000000001
100010000111111
100100000000001
100100111110001
100100000000001
100100100000001
100100010000001
100100001000001
100100000100001
100000000000001
100000000000001
111111111111111