1111111111111111111111111
1000000000000000000000001
1001111111000000000001001
1000000000000000000001001
1011111000000111100001001
1000000000000000000101001
1000000000000000000101001
1000000000000000000101001
1000111111100000000101001
1000000000000000000100001
1011111100000000000100001
1010001000011111111100001
1010001000000000000000001
1010001000001110000000001
1010001000100100000000001
1010001111100100000000101
1010000000100100010000101
1010000100100100010000101
1010100100100100010000101
1010100100100000010000101
1010100100100000010000101
1010100100000000010000101
1010100100000000010000101
1000100100000000000000101
1111111111111111111111111
