1111111111111111111111111
1000000000000000000000001
1001111111000000001111001
1000000000000000000000001
1011111011111111111111101
1010000000000000000010101
1010000011111100001010101
1010000000000000001010101
1010111111100000001010101
1010000000000000001010101
1011111100000000001010101
1010001000011111111010101
1010001000000000000000101
1010001000001110000000001
1010001000100100000000001
1010001111100100000000001
1010000000100100010000101
1010000100100101010000101
1010100100100101010000101
1010100100100101010000101
1010100100100101010000101
1010100100000100010000101
1010100100000100010000101
1000100100000100000000101
1111111111111111111111111
